       xxx   
  xxx  x1x   
xxx.x xx.xxxx
x.2.x x.....x
x...xxx.....x
x...........x
x..........3x
x.....9.....x
x...........x
x.........4xx
x.....5....x 
x..........x 
x6.........x 
xxxxxxxxxxxx 